mstqxiwrdychdlbftso	cxbsteitrrjtoyakwbo
krafoxrvfxnwixtqauj	gdrcrnsnurmiwvmldft
nooiizkqhxsibqpvocn	fzlpkpzzrdalnjaerwk
vpmmezreqfdudzsrrec	dzdqhkowtsokdkajeoz
sjwdcnswtildyodikwo	rfvnvrvhbuuhzcnjeol
kugzbbesmvuxcfiyamm	qxhxekwxmxqbjsojudt
tvxeiagvqukugjadbwm	appozmmtrayfssrgbeb
okdgaybavosvsqwqsnt	hbzxrgjzcdojpoikhqq
fshvbgiiaufaqnlrzhq	okgyqmiwtpugnnqzddt
xnbojurqzaynodvnboi	lhbasiskfqiwbwmyiyj
ddkirfrkvthvjjbopfw	pbuyyvaatlzjzyxknmm
xufyvfozqaszoekazhd	hwvuzkrihcgflcdrjbr
xsghkmvicuwpnyvqeuq	ugoqhciwlofhshwgqao
birqwcdhmeeprmqikwl	ooioxnueegwfjxowbkd
idnioqtajztctahrerd	sopiwchoqscwentnznp
iehcdadlqqxbwduogqc	lxleqiaxkmrymstflkc
fpbuunpzxxazunpjinf	llpwmwuhekwgirhjgnz
fuahytcagtoypijskxn	lppnwxvhuwvvuynigid
urouzftsmhhxhbfqygh	avsmywewvwndxiaaigj
lbceindfflavwrrsyla	qaonkeeprmzwzopfiso
xghckwhwvyglzdvslcq	fzjhnsucaklljzkclnm
xvayhmcpnlqauusjoga	napahnwtnaaewuhbomr
rajgezjhkrbdfmcvkcw	ffiwqvtzrjzpzsciclv
pprafixmttmyooxwlwc	lpivhrwzuuhwkypcier
ybefzfhubnbotytqgyt	tpwatgzrqsfrexjoyeb
esovslxkcfmrimsyuzf	oxejkplrikuvdiiqcih
jxacwabkslifhxvyfkg	tojkhesxndwvrapfsmm
usemnreotluhisomrni	xrxkwkvymveqmohklkh
gngpodmifvpzadshfzj	jklskbkxybnmdfdglso
calcdbcxmmteiojdotf	ymtsyaxmydcqgzyanju
ssrzcifnibhofypntcs	lxfczdjuskehporeuib
cpabjvaladsyqihhxfp	ajtkkbagnxxqcodxsis
ticrizapfcggwbnaulb	ljtnwsxbkjyfechvgko
tisgpjpdcwjqrgjgtkp	jkgjaqzrvslqkvuxjnb
duygxearxoswsyalkxy	gzgopficufxhmmggety
sodcyhtagutsguiedbz	gegiujicgswbvalrpwi
odvtkfpgobqcqghxgrq	xxnhvhhxtqmyfccgupf
ctmyoybrmhjqnyjoiix	iclnorlsferflzgwgxo
mtalkayxcctxtzypocp	duxmzffvsuerqcovoto
glbhdpkbbjqjvrsphjr	mryhfqxjniodnvuvhhp
roqtuxcrdrdixnpeoib	fqztkttufammfoigyvr
ghmgtvpskpquldvdvbb	gjymjstoajehgstdvlo
dzhfxrlpjkjyuenlich	wceombuqfflgynjsebr
lpyjigedluleevvaitu	hkhjmqcxoqvzjrjznxs
fcqjxybbzwjzmecaetp	eyjoofilupojcuixhqt
tskocrvdxvakkctgqjs	vvjhlgtyhqqnctpquoe
kdoavfsiutwcekapdlu	yuskftxckzjhpkvnmbc
aqukqcfpvigfworywwh	xdweuqawmyoikusqujo
mqrkyspbjikvlcdvyno	agtlivredhepovhrgii
bzczfitonousopunyyw	toquxewqwqwhviptias
smvuhtptrmzoxytddbi	riqbygisjttauimfqbn
njcqnmtlerztdswzsir	jphyrylexkummkxxjqt
xhpnffkebbtnfitynld	jsvaptdrutlundwcati
ykvedosdfmfvxhupktd	qjnemynyxlzjqyoprms
pvwucxlmjutgtbxqvnb	vossfnechwrqcjihbek
wuijaijjcrdbgwwdqif	groukifujjrkgrkvqja
pqhxfjaocjbysnteybj	bktrwfyguovmyuajmye
kryuzktbmltwgofksul	fsdkxvciinxjxcezftq
mogxtmgxwsohelrcfhy	mnihocvxlnjbcumhcbs
gmiiyztvdlkjaxjgfih	dkefwiayhctfdvwbqvo
lpyaurmnvqzujklkttv	xgkrleemxdobonyxqtn
ohztabtgxomnurixzfn	rhbrcynjadnctmabtlx
irvscoiyruefreapopm	vtfisvchnywvnytswfz
qsnwyjwkwsolszevile	gjxpxugsjlwsqdmnclq
uoqcloolxrhtbcduudy	qvmjazzrzjzolgmwzzv
gzbskyaziduoryksgww	gxetwizafbwyjcbyxkz
btplkxozkelzaxuzooo	mketvupgrgztiggsnod
epoguboyynsllmvflnl	zlawegydkkvkbtnusqd
xermkapzodltconytbo	bbgxyibwgyblcutobxb
yuakzgrwaijeunxtirh	oqnzdhkyygufvgzceka
twnrzmovvoqmvjroyus	swwcajogjulrcqvaqos
kqtwawjvehiuodpfnlc	akkaunrhzptmnvhnhgm
fpvsylzjsqnqlinacsh	oluwyvxmlzaofqcamji
trverfprsptghdkdqhp	kzmhrahlupiluisxfwn
ujzdpllgfueufpclxfq	acukbpofbwaphnzvzkq
izxdqyxfqdcfxtjrmmu	gkexqhrvfkgdsduxfjc
zggebtncvvnhntkcbqd	soxfpxywnjuloffflvo
rjwavsggejdpiovznig	cfkpimnoejtavpinwno
volzjkhiabofpyyxqbn	pwlpjxhpusroxinjfka
pdpgbsefjkjkwkmobms	mbnvnxvwhjuxxtobnbo
jgsudvtoyxqvdavjive	tyzefczkpvkrwmathoj
tqfmrpzjebuvdfrzqfb	aljxhcoxhyhtfvzutjq
kejpohuryewvmlmsptz	aoeocujzjlyvmptpkwk
pdixjlvevqwbfqxhmtx	hcuywzwgmzugevqqeqr
bowybrvfeubvmqliskg	omlfkgfcywgrndokfdj
jgehgyevwhpnhlrcotv	eqakongqnpwlqenuhem
qlrjasstindgvtzoocm	gjlvubbpttfmlajupsa
cdolzbdcygsrufyfypi	rnhakrkqjcjgrsgaijx
hlwuqlthquzjisuowxj	lmihhhrmxfvxmptsaet
gcokwjvlrtfoevjzwoe	oyaiqszeeaoevfaypqj
dbewdlpbecvzmrhxnfi	uvbgsebzbymweghgjjk
bvcyzagpsxdsvcpnuws	qxwangtstbkflrlqtnd
ltucuhflciuvgkltndc	mczudicmrwhmqyjkyik
tqspxinnxvevhghbzdy	oiqwiixzlfifdatxwke
tatcbmzuwpdtvyoshsf	okezkheoxojqbcfrlty
ledbdgguaczlxfsxnya	gtdkcpabbxlivqsbhad
qcgnefnamtveyptvhjk	ltuiwiidaccljpmbqsd
qyoxhmtqovhrnngzebx	jzbqnxkixsqinjzcrze
rjdbpckeogrczerytdf	erjgyndmetweatialps
yfsnqhyaoermdskvieg	tokijcenbjqkbxclyck
tsedirdofuiwufhzatk	xegzxokmsafaeeahhus
xeyybgkhnwltmxmdrfe	vogdtlhjhhhhrsajhik
mlogfyprhogcgkhxijo	nttfewvknjhackqpobw
cabkwwlysdlczkfrfpc	sdsleyvfxwlobroleyl
jrxvymcigwomtjvkmkw	woccybiwshtwonvlrus
hukbdidytzzrehhvkvo	mgcpizqbegmclkgyonu
ekruypczumaekuchlil	mcxtqgkxuitpxmyliwh
akeywlrjfpfuqedtzps	vtdteyyswdovgecqnys
mgcwzrnopupdavtydym	sdhmeuqwtfidshhshwm
概率是1
